000000000000000000000001000000000000000000000000000000000
000000000000000000000001000000000000000000000000000000000
000000000000000000000001000000000000000000000000000000000
000000000000000000000001000000000000000000000000000000000
000000000000000000000001000000000000000000000000000000000
000000000000000000000000000000000000000000000000000100000
000000000000000000000000000000000000000000000000000000000
000000000000000011100000000000000000000000000000100000000
000000000000000000000000000011100000000000000001000000000
000000000000000000000000000000000000000000000010000000000
111111111111111100011111122221111111111111111111111110011
100000000000000122210000111110000010000000000000000000001
100000000000000111110000000000000010000000000000000000001
100000000000000000000000000000000010000000000000000000001
100000000111000000000000000000000000000000000000000000001
100040000000001000000000000000000000000200000011110000001
100000002222200000000000000000200000000100200000000200021
111111111111111111001110001111111111111111111111111111111
000000000000000000000000000000000000000000000000000000000
000000000000000000000000000000000000000000000000000000000
000000000000000000000000000000000000000000000000000000000
000000000000000000000000000000000000000000000000000000000