000000000000000000000011100000000000000000000000000000000
000000000000000000000011100000000000000000000000000000000
000000000000000000000011100000000000000000000000000000000
000000000000000000000011100000000000000000000000000000000
000000000000000000000011100000000000000000000000000000000
000000000000000000000000000000000000000000000000000100000
000000000000000000000000000000000000000000000000000100000
000000000000000011100000000000000000000000000000100100000
000000000000000000000000000011100000000000000001000000000
000000000000000000000000000000000000000000000010000000000
111111111111111100011111122221111111111111111111111111411
000000000000000000000000111110000000000000000000000001110
000000000000000000000000000000000000000000000000000000000
000000000000000000000000000000000000000000000000000000000
000000000000000000000000000000000000000000000000000000000