0000000000000000000000000000001000000000000000000000000000000000000000000000000000100000000000000000000000000000000000000000000000000000001000000000000000000000000000000100000000000000000000000001000000000000000000000000000000000000000000000000000001
0000000000000000000000000000001000000000000000000000000000000000000000000000000000100000000000000000000000000000000000000000000000000000001000000000000000000000000000000100000000000000000000000001000000000000000000000000000000000000000000000000000001
0000000000000000000000000000001000000000000000000000000000000000000000000000000000100000000000000000000000000000000000000000000000000000001000000000000000000000000000000100000000000000000000000001000000000000000000000000000000000000000000000000000001
0000000000000000000000000000001000000000000000000000000000000000000000000000000000100000000000000000000000000000000000000000000000000000001000000000000000000000000000000100000000000000000000000001000000000000000000011111111100000000000000000000000001
0000000000000000000000000000001000000000000000000000000000000000000000000000000000100000000000000000000000000000000000000000000000000000001000000000000000000000000000000100000000000000000000000001000000000000000000000000000111111100000001111111111111
0000000000000000000000000000001000000000000000000000000000000000000000000000000000100000000000000000000000000000000000000000000000000000001000000000000000000000000000000100000000000000000000000001000000000011100000000000000100000000000000000000000001
0000000000000000000000000000000000000000000000000000000000000000000000000000000000100000000000000000000000000000000000000000000000000000001000000000000000000000000000000100000000000000000000000001000000000000000000000000000100000000000000000000000001
0000000000000000000000000000000000000000000000000000000000000000000000000000000000100000000000000000000000000000000000000000000000000000001000000000000000000000000000000000000000000000000000000001000000000000000000000000000100000000000000000000000001
0000000000000000000000000000000110000000000000000000000000000000000000000000000000100000000000000000000000000000000000000000000000000000001000000000000000000000000000000000000000000000000000000001000000000000000000110000000100000001111100000000000001
0000000000000000000000000000000000000000000000000000000000000000000000000000000000100000000000000000000000000000000000000000000110000000021200000000000000000000000110000100000000000000000000000001000000000000000000000000000100000000000000000000000001
0000000000000000000000001110001000000001110000000000000000000000000000000000000000100000000000000000000000000000000000000000000000000000011100000000000000000000001000000100000000000000000000000001000000000000000000000000000100000000000000000000000001
0000000000000000000000000000001000000000000000000000000000000000000000000000000002120000000000000000000000000000000000000011000000000000000000000000000000000000000000000100000000000000000000000000000000000001100000000000000100000000000000000000000001
0000000000000000000000000000001000000000000000000000000000000000000000000000000001110000000000000000000000000000000000000000000000001100000000000000000000000011000000000100000000000000000000000000000000000000000000000000000100000000000000000000000001
0000000000000000000011100000001000000000000000000000000000000000000000000000000000000000000000001110000000000000000011000000000000000000000000000000000000000000000000000100000000000000000000000000000000000000000000110000000100000000000000000000000001
0000000000000000000000000000001000000000000000000000000000000000000000000000000000000000000011100000000000000000000000000000000000000000000000000000000001100000000000000100000000000000000000000000000000000000000000000000000100000000000000000000000001
1111111111111111111100000000001000000001111111111111111111110000000000000000111111111111111100000000000000001111111111111111110000000000000001111111111111111100000000000100001111111111111100000000000000001111111111111100000100000001111111110000001111
0000000000000000000000000000001000000000000000000000000000000000000001110010000000000000000000000001110011000000000000000000000000001100000000000000000000000000000000000100000000000000000000000000000000000000000000000000000100000000000000000000001000
0000000000000000000000000000001000000000000000000000000000000000011000000000000000100000000000000000000000000000000000000000000000000000021200000000000000000000000000000100000000000000000000000000000000000000000000000000000100000000000000000000001000
0000000000000000000000000000001000000000000000000000000000001110000000000000000000100000000000000000000000000000000000000000000000000000011100000000000000000000000000000100000000000000000000000111110000000000000000000000000100000000000000000111111000
0000000000000000000000000000001000000000000000000000000000000000000000000000000000100000000000000000000000000000000000000000000000000000001000000000000000000000000000000100000000000000000000000001000000000000000000000000000000000000000000000100000000
0000000000000000000000000000001000000000000000000000000000000000000000000000000000100000000000000000000000000000000000000000000000000000001000000000000000000000000000000100000000000000000000000001000000000000000000000000000000000000000000000100000000
0000000000000000000000000000001000000000000000000000000000000000000000000000000000100000000000000000000000000000000000000000000000000000001000000000000000000000000000000100000000000000000000000001000000000011100000000000000000000000000000000100000000
0000000000000000000000000000001000000000000000000000000000000000000000000000000000100000000000000000000000000000000000000000000000000000001000000000000000000000000000000100000000000000000000000001000000000000000000000000000000000000000000000100000000
0000000000000000000000000000001000000000000000000000000000000000000000000000000000100000000000000000000000000000000000000000000000000000001000000000000000000000000000000100000000000000000000000001000000000000000000011100000100000001111111111100000000
0000000000000000000000000000001000000000000000000000000000000000000000000000000000100000000000000000000000000000000000000000000000000000001000000000000000000000000000000100000000000000000000000001000000000000000000000000000100000000000000000000000000
0000000000000000000000000000001000000000000000000000000000000000000000000000000000100000000000000000000000000000000000000000000000000000010000000000000000000000000000000100000000000000000000000001000000000000000000000000000100000000000000000000000000