0000000000000000111000000000000000000000000000
0000000000000000111000000000000000000000000000
0000000000000000111000000000000000000000000000
0000000000000000111000000000000000000000000000
0000000000000000111000000000000000000000000000
0000000000000000000000000000000000000000100000
0000000000000000000000000000000000000000100000
0000000000111000000000000000000000000100100000
0000000000000000000000121000000000001000000000
0000000000000000000000000000000000010000000000
1111111111000111111222222221111133111111111411
0000000000000000001111111111000133100000001110
0000000000000000000000000000000133100000000000
0000000000000000000000000000000133100000000000
0000000000000000000000000000000111100000000000